------##------
----##--##----
---#-o--o-#---
---#------#---
---#-\__/-#---
----##--##----
------##------